1111111111111111111111111111111
100000000100000000000000010C001
100000000100000000000000000EC01
1000000000000000C00000000111111
1000000001000000000000000000001
1000000001000000000000000000001
1000000C0000000C000000000000001
1000J000000000000000000C0000001
1000000000000000000000000000001
1000000P00000000011111111000001
1000000000000000000000000000001
10000011100000000000B0000000001
100000C000000000000000000000001
10000000000000011111100000C0001
1000C00000000000000000000000001
1000000000011111111111111100001
1111111111111111111111111111111
